15 15
@            D 
 # ##### DDD D 
 #   #*# DK    
 ### # #   D D 
  *#   * DDD D 
 ### # E DKD D 
    *# E DI  D 
EE*### E D DDDG
 EK    E   DK  
 EE EEEE D DDD 
         D     
 EEEEE E DDDDD 
 EI    E       
 E EE EEEEE DD 
T  E        D  
