15 15
### DDDD     EE
# I DK   *K   E
#     DDD ## T 
  E*   WD #    
 *E E  DD #   I
  EEE     ###  
       *    #  
 K  EEEEE *    
 *K E        K 
      ###*  E  
  D     #   E  
  DDDDD ### E  
I           E D
E*G E  * * *  D
EE  EEEE     DD
